##############################
#............................#
#...,,,,,,,..................#
#...,,,,,,,..................#
#............................#
#...########......####.###...#                 #############################
#...#......#......#......#...#########         #...........................#
#...#.............#......#...........#         #...........................#
#...#......#......#..?...#...#######.#         #...........................#
#...########......########...#     #.#         #...........................#
#............................#     #.###########...........................#
#............................#     #.......................................#
#............................#     #############...........................#
#.......P.......P............#                 #...........................#
#....................P.......#                 #...........................#
#............................#                 #...........................#
#...........P................#                 #...........................#
#............................#                 #############################
#............................#
##############################